  #### 
###  #
#  B ##
# #OO #
#P O# #
##B B #
 #  ###
 ####