   ######
####    #
#  #    #
#O     ##
#O#### ###
#O#  # B #
###  #BB #
     #  P#
     #####