  #####
###   #
#OPB  #
### BO#
#O##B #
# # O ##
#B @BBO#
#   O  #
########