    #####
    #   #
    #B  #
  ###  B##
  #  B B #
### # ## #   ######
#   # ## #####  OO#
# B  B          OO#
##### ### #P##  OO#
    #     #########
    #######