 ###
 #P ###
 # B  #
### # ##
#O# #  #
#OB  # #
#O   B #
########