#####
#   #
# B # ###
# B # #O#
### ###O#
 ##     O#
 # PB#  #
 #   ####
 #####