############
# P #  B  O#
#B   B O   #
#OBO#      #
############